XXXXXXXXXXXXXXXXXXXXXX
XaX729173817458123921X
XX33b72XXXXXX8XXXX2X1X
XXXXX72X73X27X843X8X4X
X49c84X3901999238X8X9X
X58573XXXXXXX8XX8X7X1X
X64877298883XX7X9X8X9X
X79281747756X38X2X8X9X
XXXXXXX27199X99X9X19XX
Xd11111111111119999XeX
XXXXXXXXXXXXXXXXXXXXXX