-------------------------------------------------------------------------------------------------XXXXXXXX-----------------------------------------------------------------------------------------------
------------------------------------------------------------------------------B-------------------------??-----------o----------------------------------------------------------------------------------
------------------------------------------B--------------------------------------------------------------------------------------------------------?--------------------------------BBBBBBBB------------
------------------------------------------------------------------------------------------------------------------------------------------???-----------------------------------------------------------
-------------------------------------------------X-------------------------------------XXXXXXX----------------------------------------------------------------------------------------------------------
------------------------------------------------XX------------------------------------------------------------------------X-----------------------------------------------------------------------------
--------------------------------------------T--XXX--------------------------------BBBBB------?-----------------------X------------------------------------XXXXXXXX-----o--------------------------------
--------------------------------------------|-XXXX------------------------------------------------------------------------------------B--X-------------------------------------------------------------v
--------------------------------------------|XXXXX-----------------------------------------------------------------------------------------------------------------------------------------------------f
---B----------------------------------------|XXXXX--------------------------------------------------?---------------------------------------------------------------------------XXXXXXX----------------f
-------------------------------------------X|XXXXX-----------------------------------X-----------------------------------------------??---------------------------------------------------------T------f
------------------------------------------XX|XXXXX----------------------------------XX------------------T-------------------------------??----------------------------------------------T-------|------f
-----------------------------------------XXX|XXXXX---------------------------------XXX--B---------------|--------------------------------o--?----------------------XXXX----------M------|-------|------f
----------------------------------------XXXX|XXXXX--------------------------------XXXX------------------|--------------------------X----------------------------------------------------|-----o-|------f
m--------------------------------------XXXXX|XXXXX-------------------------------XXXXX----E-------------|--X----o-------------E-----E--X--------EE---------------------E----------------|-------|------X
XX---------XXXXXXXXXXXXXXXXXXXXXXXXXXXXXXXXX|XXXXXXXXXXXXXXXXXXXXXXX???????XXXXXXXXXXXX--------XXXXXXXXX|XXXXXXXXXXXXXXXXXXX-----XXXXXXXXXXXXXXXXXXXXXXXXXXXXXXXXXXXXXXXXXXXXXXXXXXXXXXX|XXXXXXX|XXXXXXX
